############
#          #
#P   X   o #
####     ###
  ########  